Dungeon
HHHHHHHHHHHHHHHHHHHHHHH
#######################
#B.........#.........B#
#.###.####.#.####.###.#
#.###.####.#.####.###.#
#.....................#
#.###.#.#######.#.###.#
#.....#....#....#.....#
#####.#### # ####.#####
    #.#         #.#    
#####.# ###_### #.#####
|       #GGcGG#       |
#####.# ####### #.#####
    #.#         #.#    
#####.# ####### #.#####
#..........#..........#
#.###.####.#.####.###.#
#B..#......P......#..B#
###.#.#.#######.#.#.###
#.....#....#....#.....#
#.########.#.########.#
#.....................#
#######################
ggggggggggggggggggggggg
ggggggggggggggggggggggg
ggggggggggggggggggggggg
ggggggggggggggggggggggg
